111111111111111111111111111111111111
1001CCCCCCCCCCCCCCCCCCC1000001CCCCC1
100001111100000000000000000001C1CCC1
100011000000000000000000000001110001
100011000111111111000000000000000001
1000110001CCCCCCCC000011111111111111
100011000111111111000011E000111CCCC1
1000110000000000000000111110111111C1
1P00110000000000000000000000CCCCCCC1
111111111111111111111111111111111111