111111111111111111111111111111111111
10010000000C000000000001000001000001
100001111100000000000000000001010001
1P0011000000000000000000000001110001
1P0011000111111111000000000000000001
1P00110001C0000000000011111111111111
1P0011000111111111000011E000111C0001
1P0011000000000000000011111011111101
1P0011C00000000000000000000000000001
111111111111111111111111111111111111