1111111111111
100100000P0C1
1000P11111001
1P0011E000001
1111111111111