1111111111111
1001000000001
1000011111001
1P00110C000E1
1111111111111
1111111111111
10010000C0001
1000011111001
1000110000001
1111111111111